3 15 5 20 15 15 20 15
8 8
2 4 2 4 3 2 1 4
2 1 2 1 11 2 1 1 
1 -10 -10 3 2 -10 -10 4
2 1 3 15 4 1 1 2
13 3 2 -10 -10 2 4 3
2 2 3 -10 -10 1 2 1
3 12 3 3 2 14 2 4
-10 2 1 3 1 11 4 -10 