1 13
0 10 10 15 10 10
8 8
-10 0 4 4 3 4 4 -10
-10 -10 2 0 2 1 -10 -10
-10 -10 -10 1 0 -10 -10 -10
-10 -10 -10 3 0 -10 -10 -10 
-10 -10 -10 2 4 -10 -10 -10 
-10 -10 2 3 1 1 -10 -10
-10 0 4 3 3 2 4 -10
4 4 0 2 1 3 2 0